# #####
#     #
##### #
#     
# ### #
# #   #
# #####