#######
#     #
##### #
#      
# ### #
# #   #
### ###