# #####
#     #
##### #
#     #
# ### #
# #   #
# #####